-1,1,1,1
-1,2,2,2
-1,3,3,3
-1,4,4,4
-1,5,5,5