-16,1,90,120,1,45,75,2,0,0,0,20,20,20,0,30,30
-1,1,90,120,1,45,90,2,0,15,15,20,20,20,1,30,30
-1,1,0,105,1,45,105,2,0,75,45,20,20,20,0,30,30
-1,1,15,105,0,0,0,2,0,105,15,20,20,20,0,30,30
-1,1,30,105,0,0,0,2,0,105,30,20,20,20,0,30,30
-1,1,45,105,0,0,0,0,0,0,0,0,0,0,0,0,0
-1,1,60,105,0,0,0,0,0,0,0,0,0,0,0,0,0
-1,1,75,120,0,0,0,0,0,0,0,0,0,0,0,0,0
-1,1,90,135,0,0,0,0,0,0,0,0,0,0,0,0,0
