-16,1,0,0,1,20,20,0,1,50,200,20,20,20,2,30,30
-1,1,0,75,1,30,30,2,1,252,200,20,20,20,0,30,30
-1,1,15,30,1,40,40,0,0,0,0,0,0,0,0,0,0
-1,1,15,60,0,0,0,0,0,0,0,0,0,0,0,0,0
-1,1,30,0,0,0,0,0,0,0,0,0,0,0,0,0,0
-1,1,30,45,0,0,0,0,0,0,0,0,0,0,0,0,0
-1,1,60,105,0,0,0,0,0,0,0,0,0,0,0,0,0
