-17,1,60,60,1,45,75,2,0,0,0,20,20,20,0,30,30
-1,1,60,75,1,45,90,2,0,15,15,20,20,20,1,30,30
-1,1,135,45,1,45,105,2,0,75,45,20,20,20,0,30,30
-1,1,135,60,0,0,0,2,0,105,15,20,20,20,0,30,30
-1,1,135,75,0,0,0,2,0,105,30,20,20,20,0,30,30
-1,1,135,90,0,0,0,0,0,0,0,0,0,0,0,0,0
-1,1,135,105,0,0,0,0,0,0,0,0,0,0,0,0,0
-1,1,135,120,0,0,0,0,0,0,0,0,0,0,0,0,0
-1,1,135,135,0,0,0,0,0,0,0,0,0,0,0,0,0
